0,0,0,0,0,0,0,0,0,0,0,0,0,0,0,0,
0,0,0,0,0,0,0,0,0,0,0,0,0,0,0,0,
0,0,0,0,0,0,0,0,86,86,86,86,86,0,0,0,
0,0,0,0,0,86,86,86,86,90,90,90,86,0,0,0,
0,0,0,0,0,86,90,90,86,90,90,90,86,86,86,86,
0,0,0,0,0,86,90,90,90,90,90,90,90,90,90,86,
0,0,0,0,0,86,90,90,90,86,90,90,90,86,90,86,
0,0,0,0,0,86,86,86,90,86,90,90,90,86,90,86,
0,0,0,0,0,0,86,90,90,86,86,86,86,86,90,86,
0,0,0,0,0,86,90,90,90,90,90,90,90,90,90,86,
0,0,0,0,0,0,86,86,86,86,86,86,86,86,86,86
nextlayer
0,0,0,0,0,0,0,0,0,0,0,0,0,0,0,0,
0,0,0,0,0,0,0,0,0,0,0,0,0,0,0,0,
0,0,0,0,0,0,0,0,0,0,0,0,0,0,0,0,
0,0,0,0,0,0,0,0,0,0,0,0,0,0,0,0,
0,0,0,0,0,0,0,0,0,0,0,0,0,0,0,0,
0,0,0,0,0,0,0,0,0,0,0,0,0,0,0,0,
0,0,0,0,0,0,0,0,0,0,0,0,0,0,0,0,
0,0,0,0,0,0,0,0,0,0,0,0,0,0,0,0,
0,0,0,0,0,0,0,0,0,0,0,0,0,0,0,0,
0,0,0,0,0,0,0,0,0,39,39,39,39,39,0,0,
0,0,0,0,0,0,0,0,0,0,0,0,0,0,0,0
nextlayer
0,0,0,0,0,0,0,0,0,0,0,0,0,0,0,0,
0,0,0,0,0,0,0,0,0,0,0,0,0,0,0,0,
0,0,0,0,0,0,0,0,0,0,0,0,0,0,0,0,
0,0,0,0,0,0,0,0,0,0,0,0,0,0,0,0,
0,0,0,0,0,0,0,0,0,5,0,0,0,0,0,0,
0,0,0,0,0,0,0,5,5,0,0,0,0,0,0,0,
0,0,0,0,0,0,0,53,0,0,5,0,5,0,0,0,
0,0,0,0,0,0,0,0,0,0,0,0,0,0,0,0,
0,0,0,0,0,0,0,0,0,0,0,0,0,0,0,0,
0,0,0,0,0,0,0,0,0,0,0,0,0,0,0,0,
0,0,0,0,0,0,0,0,0,0,0,0,0,0,0,0
end