0,0,0,0,0,0,0,0,0,0,0,0,0,0,0,0,0,0,0,0,0,
0,0,0,0,0,0,0,0,101,101,101,101,0,0,0,0,0,0,0,0,0,
0,0,0,0,0,101,101,101,101,90,90,101,101,101,101,0,0,0,0,0,0,
0,0,0,0,0,101,90,90,90,90,90,90,90,90,101,0,0,0,0,0,0,
0,0,0,0,0,101,90,90,90,90,90,90,90,90,101,0,0,0,0,0,0,
0,0,0,0,0,101,90,90,90,90,101,90,90,90,101,0,0,0,0,0,0,
0,0,0,0,0,101,101,101,101,101,101,90,90,90,101,101,0,0,0,0,0,
0,0,0,0,0,0,0,0,0,0,101,90,90,90,90,101,0,0,0,0,0,
0,0,0,0,0,0,0,0,0,0,101,90,90,90,90,101,0,0,0,0,0,
0,0,0,0,0,0,0,0,0,0,101,90,90,90,101,101,0,0,0,0,0,
0,0,0,0,0,0,0,0,0,0,101,101,101,101,101,0,0,0,0,0,0,
0,0,0,0,0,0,0,0,0,0,0,0,0,0,0,0,0,0,0,0,0
nextlayer
0,0,0,0,0,0,0,0,0,0,0,0,0,0,0,0,0,0,0,0,0,
0,0,0,0,0,0,0,0,0,0,0,0,0,0,0,0,0,0,0,0,0,
0,0,0,0,0,0,0,0,0,0,0,0,0,0,0,0,0,0,0,0,0,
0,0,0,0,0,0,0,0,0,0,0,0,0,0,0,0,0,0,0,0,0,
0,0,0,0,0,0,39,0,0,39,39,39,39,0,0,0,0,0,0,0,0,
0,0,0,0,0,0,0,0,0,0,0,0,39,0,0,0,0,0,0,0,0,
0,0,0,0,0,0,0,0,0,0,0,0,39,0,0,0,0,0,0,0,0,
0,0,0,0,0,0,0,0,0,0,0,0,39,0,0,0,0,0,0,0,0,
0,0,0,0,0,0,0,0,0,0,0,0,0,0,0,0,0,0,0,0,0,
0,0,0,0,0,0,0,0,0,0,0,0,0,0,0,0,0,0,0,0,0,
0,0,0,0,0,0,0,0,0,0,0,0,0,0,0,0,0,0,0,0,0,
0,0,0,0,0,0,0,0,0,0,0,0,0,0,0,0,0,0,0,0,0
nextlayer
0,0,0,0,0,0,0,0,0,0,0,0,0,0,0,0,0,0,0,0,0,
0,0,0,0,0,0,0,0,0,0,0,0,0,0,0,0,0,0,0,0,0,
0,0,0,0,0,0,0,0,0,0,0,0,0,0,0,0,0,0,0,0,0,
0,0,0,0,0,0,0,0,0,0,0,0,0,0,0,0,0,0,0,0,0,
0,0,0,0,0,0,0,8,0,8,8,8,8,0,0,0,0,0,0,0,0,
0,0,0,0,0,0,0,0,0,53,0,0,8,0,0,0,0,0,0,0,0,
0,0,0,0,0,0,0,0,0,0,0,0,8,0,0,0,0,0,0,0,0,
0,0,0,0,0,0,0,0,0,0,0,0,8,0,0,0,0,0,0,0,0,
0,0,0,0,0,0,0,0,0,0,0,0,0,0,0,0,0,0,0,0,0,
0,0,0,0,0,0,0,0,0,0,0,0,0,0,0,0,0,0,0,0,0,
0,0,0,0,0,0,0,0,0,0,0,0,0,0,0,0,0,0,0,0,0,
0,0,0,0,0,0,0,0,0,0,0,0,0,0,0,0,0,0,0,0,0
end
